~~~~~~~~~~~~~~~~~~~~~~~~~~~~~~~~~~~~~~~~~~~~~~~~~~~~~~~~~~~~~~~~~~~~~~~~~~~~~~~~~~~~~
~~~~~~~~~~~~~~~~~~~~~~~~~~~~~~~~~~~~~~~~~~~~~~~~~~~~~~~~~~~~~~~~~~~~~~~~~~~~~~~~~~~~~
~~~~~~~~~~~~~~~~~~~~~~~~~~~~~~~~~~~~~~~~~~~~~~~~~~~~~~~~~~~~~~~~~~~~~~~~~~~~~~~~~~~~~
~~~~~~~~~~~~~~~~~~~~~~~~~~~~~~~~~~~~~~~~~~~~~~~~~~~~~~~~~~~~~~~~~~~~~~~~~~~~~~~~~~~~~
~~~~~~~~~~~~~~~~~~~~~~~~~~~~~~~~~~~~~~~~~~~~~~~~~~~~~~~~~~~~~~~~~~~~~~~~~~~~~~~~~~~~~
~~~~~~~~~~~~~~~~~~~~~~~~~~~~~~~~~~~~~~~~~~~~~~~~~~~~~~~~~~~~~~~~~~~~~~~~~~~~~~~~~~~~~
~~~~~~~~~~~~~~~~~~~~~~~~~~~~~~~~~~~~~~~~~~~~~~~~~~~~~~~~~~~~~~~~~~~~~~~~~~~~~~~~~~~~~
~~~~~~~~~~~~~~~~~~~~~~~~~~~~~~~~~~~~~~~~~~~~~~~~~~~~~~~~~~~~~~~~~~~~~~~~~~~~~~~~~~~~~
~~~~~~~~~~~~~~~~~~~~~~~~~~~~~~~~~~~~~~~~~~~~~~~~~~~~~~~~~~~~~~~~~~~~~~~~~~~~~~~~~~~~~
~~~~~~~~~~~~~~~~~~~~~~~~~~~~~~~~~~~~~~~~~~~~~~~~~~~~~~~~~~~~~~~~~~~~~~~~~~~~~~~~~~~~~
~~~~~~~~~~~~~~~~~~~~~~~~~~~~~~~~~~~~~~~~~~~~~~~~~~~~~~~~~~~~~~~~~~~~~~~~~~~~~~~~~~~~~
~~~~~~~~~~~~~~~~~~~~~~~~~~~~~~~~~~~~~~~~~~~~~~~~~~~~~~~~~~~~~~~~~~~~~~~~~~~~~~~~~~~~~
~~~~~~~~~~~~~~~~~~~~~~~~~~~~~~~~~~~~~~~~~~~~~~~~~~~~~~~~~~~~~~~~~~~~~~~~~~~~~~~~~~~~~
~~~~~~~~~~~~~~~~~~~~~~~~~~~~~~~~~~~~~~~~~~~~~~~~~~~~~~~~~~~~~~~~~~~~~~~~~~~~~~~~~~~~~
~~~~~~~~~~~~~~~~~~~~~~~~~~~~~~~~~~~~~~~~~~~~~~~~~~~~~~~~~~~~~~~~~~~~~~~~~~~~~~~~~~~~~
~~~~~~~~~~~~~~~~~~~~~~~~~~~~~~~~~~~~~~~~~~~~~~~~~~~~~~~~~~~~~~~~~~~~~~~~~~~~~~~~~~~~~
~~~~~~~~~~~~~~~~~~~~~~~~~~~~~~~~~~~~~~~~~~~~~~~~~~~~~~~~~~~~~~~~~~~~~~~~~~~~~~~~~~~~~
~~~~~~~~~~~~~~~~~~~~~~~~~~~~~~~~~~~~~~~~~~~~~~~~~~~~~~~~~~~~~~~~~~~~~~~~~~~~~~~~~~~~~
~~~~~~~~~~~~~~~~~~~~~~~~~~~~~~~~~~~~~~~~~~~~~~~~~~~~~~~~~~~~~~~~~~~~~~~~~~~~~~~~~~~~~
~~~~~~~~~~~~##########################################################~~~~~~~~~~~~~~~
~~~~~~~~~~~~#.......#.......##....##.............#~~~~#.............$###~~~~~~~~~~~~~
~~~~~~~~~~~~#.......#..............#.............#~~~~#..............##~~~~~~~~~~~~~~
~~~~~~~~~~~~##.#########.#################.#############.########.#####~~~~~~~~~~~~~~
~~~~~~~~~~~~#...............#~~~~~~~~~~~~#.................####....#.##~~~~~~~~~~~~~~
~~~~~~~~~~~~#........#......#~~~~~~~~~~~~#......#.............#......##~~~~~~~~~~~~~~
~~~~~~~~~~~~#...#....#......#~~~~~~~~~~~~#......#.....#...#.....#....##~~~~~~~~~~~~~~
~~~~~~~~~~~~#........#......#~~~~#########......#.............#......##~~~~~~~~~~~~~~
~~~~~~~~~~~~##.......#......#~~~~#..............###.....#.....##.#...##~~~~~~~~~~~~~~
~~~~~~~~~~~~####.######..#####################.############.########.##~~~~~~~~~~~~~~
~~~~~~~~~~~~#........................................................##~~~~~~~~~~~~~~
~~~~~~~~~~~~#........................................................##~~~~~~~~~~~~~~
~~~~~~~~~~~~#........................................................##~~~~~~~~~~~~~~
~~~~~~~~~~~~##########################################...##############~~~~~~~~~~~~~~
~~~~~~~~~~~~#~~~~~~~~~~~~~~~~~~~~~~~~~~~~~~~~~~~~~~###...####~~~~~~~~~#~~~~~~~~~~~~~~
~~~~~~~~~~~~##~~~~~~~~~~~~~~~~~~~~~~~~~~~~~~~~~~~~~###...####~~~~~~~~~#~~~~~~~~~~~~~~
~~~~~~~~~~~~##########################################...##############~~~~~~~~~~~~~~
~~~~~~~~~~~~#~~~~~~~~~~~~~~~~~~~~#...................................##~~~~~~~~~~~~~~
~~~~~~~~~~~~#~~~~~~~~~~~~~~~~~~~~#.....................###########...##~~~~~~~~~~~~~~
~~~~~~~~~~~~#######################.###.##########.######~~~~~######.##~~~~~~~~~~~~~~
~~~~~~~~~~~~###########...........#......#~~~~#........#######.......##~~~~~~~~~~~~~~
~~~~~~~~~~~~##..........#.........#......#~~~~#........#.............##~~~~~~~~~~~~~~
~~~~~~~~~~~~##......#...#.........#......#~~~~#...##...#...#.........##~~~~~~~~~~~~~~
~~~~~~~~~~~~##..........#.....#...#......#~~~~#...##...#.......#.....##~~~~~~~~~~~~~~
~~~~~~~~~~~~##..........#................#~~~~#........#...........####~~~~~~~~~~~~~~
~~~~~~~~~~~~##.##########.###########.##########.#######.####.#########~~~~~~~~~~~~~~
~~~~~~~~~~~~#..................................................###~~~##~~~~~~~~~~~~~~
~~~~~~~~~~~~#####....................#................#........#~~~~~##~~~~~~~~~~~~~~
~~~~~~~~~~~~##############################............###......########~~~~~~~~~~~~~~
~~~~~~~~~~~~#####################~~~~~######.############.##.........##~~~~~~~~~~~~~~
~~~~~~~~~~~~#~~~~~~~~~~~~~~~~~~~~~~~~~#.........#~~#.......#.........##~~~~~~~~~~~~~~
~~~~~~~~~~~~###################################.#############........##~~~~~~~~~~~~~~
~~~~~~~~~~~~################..###~~~~~#########......##########......##~~~~~~~~~~~~~~
~~~~~~~~~~~~###.....########..###~~~~~#..............#~~~~~~~~##.....##~~~~~~~~~~~~~~
~~~~~~~~~~~~###...##########..####~~~######.#######.##############...##~~~~~~~~~~~~~~
~~~~~~~~~~~~#..........#.........######......#.........#............###~~~~~~~~~~~~~~
~~~~~~~~~~~~#########..#.....................#........#.....#.......##~~~~~~~~~~~~~~~
~~~~~~~~~~~~~~~#.......#.........#####.......#.......#......#.......##~~~~~~~~~~~~~~~
~~~~~~~~~~~~#####......#.........######......#......#.......#.......##~~~~~~~~~~~~~~~
~~~~~~~~~~~~########.######.######.####.#######.#######.######.#######~~~~~~~~~~~~~~~
~~~~~~~~~~~~#####@..................................................##~~~~~~~~~~~~~~~
~~~~~~~~~~~~#####.####################################################~~~~~~~~~~~~~~~
~~~~~~~~~~~~#####.#~~~~~~~~~~~~~~~~~~~~~~~~~~~~~~~~~~~~~~~~~~~~~~~~~##~~~~~~~~~~~~~~~
~~~~~~~~~~~~#####.###~~~~~~~~~~~~~~~~~~~~~~~~~~~~~~~~~~~~~~~~~~~~~~~##~~~~~~~~~~~~~~~
~~~~~~~~~~~~#####.###~~~~~~~~~~~~~~~~~~~~~~~~~~~~~~~~~~~~~~~~~~~~~~~##~~~~~~~~~~~~~~~
~~~~~~~~~~~~#####2###~~~~~~~~~~~~~~~~~~~~~~~~~~~~~~~~~~~~~~~~~~~~~~~##~~~~~~~~~~~~~~~
~~~~~~~~~~~~~~~#######################################################~~~~~~~~~~~~~~~
~~~~~~~~~~~~###########~~~~~~~~~~~~~~~~~~~~~~~~~~~~~~~~~~~~~~~~~~~~~~~~~~~~~~~~~~~~~~
~~~~~~~~~~~~############################################################~~~~~~~~~~~~~
~~~~~~~~~~~~~~~~~~~~~~~~~~~~~~~~~~~~~~~~~~~~~~~~~~~~~~~~~~~~~~~~~~~~~~~~~~~~~~~~~~~~~
~~~~~~~~~~~~~~~~~~~~~~~~~~~~~~~~~~~~~~~~~~~~~~~~~~~~~~~~~~~~~~~~~~~~~~~~~~~~~~~~~~~~~
~~~~~~~~~~~~~~~~~~~~~~~~~~~~~~~~~~~~~~~~~~~~~~~~~~~~~~~~~~~~~~~~~~~~~~~~~~~~~~~~~~~~~
~~~~~~~~~~~~~~~~~~~~~~~~~~~~~~~~~~~~~~~~~~~~~~~~~~~~~~~~~~~~~~~~~~~~~~~~~~~~~~~~~~~~~
~~~~~~~~~~~~~~~~~~~~~~~~~~~~~~~~~~~~~~~~~~~~~~~~~~~~~~~~~~~~~~~~~~~~~~~~~~~~~~~~~~~~~
~~~~~~~~~~~~~~~~~~~~~~~~~~~~~~~~~~~~~~~~~~~~~~~~~~~~~~~~~~~~~~~~~~~~~~~~~~~~~~~~~~~~~
~~~~~~~~~~~~~~~~~~~~~~~~~~~~~~~~~~~~~~~~~~~~~~~~~~~~~~~~~~~~~~~~~~~~~~~~~~~~~~~~~~~~~
~~~~~~~~~~~~~~~~~~~~~~~~~~~~~~~~~~~~~~~~~~~~~~~~~~~~~~~~~~~~~~~~~~~~~~~~~~~~~~~~~~~~~
~~~~~~~~~~~~~~~~~~~~~~~~~~~~~~~~~~~~~~~~~~~~~~~~~~~~~~~~~~~~~~~~~~~~~~~~~~~~~~~~~~~~~
~~~~~~~~~~~~~~~~~~~~~~~~~~~~~~~~~~~~~~~~~~~~~~~~~~~~~~~~~~~~~~~~~~~~~~~~~~~~~~~~~~~~~
~~~~~~~~~~~~~~~~~~~~~~~~~~~~~~~~~~~~~~~~~~~~~~~~~~~~~~~~~~~~~~~~~~~~~~~~~~~~~~~~~~~~~
~~~~~~~~~~~~~~~~~~~~~~~~~~~~~~~~~~~~~~~~~~~~~~~~~~~~~~~~~~~~~~~~~~~~~~~~~~~~~~~~~~~~~
~~~~~~~~~~~~~~~~~~~~~~~~~~~~~~~~~~~~~~~~~~~~~~~~~~~~~~~~~~~~~~~~~~~~~~~~~~~~~~~~~~~~~
~~~~~~~~~~~~~~~~~~~~~~~~~~~~~~~~~~~~~~~~~~~~~~~~~~~~~~~~~~~~~~~~~~~~~~~~~~~~~~~~~~~~~
~~~~~~~~~~~~~~~~~~~~~~~~~~~~~~~~~~~~~~~~~~~~~~~~~~~~~~~~~~~~~~~~~~~~~~~~~~~~~~~~~~~~~
~~~~~~~~~~~~~~~~~~~~~~~~~~~~~~~~~~~~~~~~~~~~~~~~~~~~~~~~~~~~~~~~~~~~~~~~~~~~~~~~~~~~~
~~~~~~~~~~~~~~~~~~~~~~~~~~~~~~~~~~~~~~~~~~~~~~~~~~~~~~~~~~~~~~~~~~~~~~~~~~~~~~~~~~~~~