~~~~~~~~~~~~~~~~~~~~~~~~~~~~~~~~~~~~~~~~~~~~~~~~~~~~~~~~~~~~~~~~~
~~~~~~~~~~~~~~~~~~~~~~~~~~~~~~~~~~~~~~~~~~~~~~~~~~~~~~~~~~~~~~~~~
~~~~~~~~~~~~~~~~~~~~~~~~~~~~~~~~~~~~~~~~~~~~~~~~~~~~~~~~~~~~~~~~~
~~~~~~~~~~~~~~~~~~~~~~~~~~~~~~~~~~~~~~~~~~~~~~~~~~~~~~~~~~~~~~~~~
~~~~~~~~~~~~~~~~~~~~~~~~~~~~~~~~~~~~~~~~~~~~~~~~~~~~~~~~~~~~~~~~~
~~~~~######################################################~~~~~~
~~~~~~################################~~~~~~~~~~~~~~~~~~~~~~~~~~~
~~~~~~~~#.........................#~~#~~~~~~~~~~~~~~~~~~~~~~~~~~~
~~~~~~~~#......###.#.###.....##...#~~#~~~~~~~~~~~~~~~~~~~~~~~~~~~
~~~~~~~~#..#######.#...#####.##..#####~~~~~~~~~~~~~~~~~~~~~~~~~~~
~~~~~~~~#......@##.#...#..#..##......#~~~~~~~~~~~~~~~~~~~~~~~~~~~
~~~~~~~~#.####..##.#...#.....##......#~~~~~~~~~~~~~~~~~~~~~~~~~~~
~~~~~~~~#..###..#......#..#..##.#....#~~~~~~~~~~~~~~~~~~~~~~~~~~~
~~~~~~~~#.2.....#..#...#..#..##...#..#~~~~~~~~~~~~~~~~~~~~~~~~~~~
~~~~~~~~#..######......#.....##......#~~~~~~~~~~~~~~~~~~~~~~~~~~~
~~~~~~~~#..###.....#.##########.#....#~~~~~~~~~~~~~~~~~~~~~~~~~~~
~~~~~~~~######..####.###....#........#~~~~~~~~~~~~~~~~~~~~~~~~~~~
~~~~~~~~#...................#..#####.#~~~~~~~~~~~~~~~~~~~~~~~~~~~
~~~~~~~~####..####..#####.###..#.....#~~~~~~~~~~~~~~~~~~~~~~~~~~~
~~~~~~~~#......###..###....##..#..#..#~~~~~~~~~~~~~~~~~~~~~~~~~~~
~~~~~~~~#....#.###..###.....#..#.....#~~~~~~~~~~~~~~~~~~~~~~~~~~~
~~~~~~~~#.#....###......#...#..#######~~~~~~~~~~~~~~~~~~~~~~~~~~~
~~~~~~~~#....#####.###...#..#.......##~~~~~~~~~~~~~~~~~~~~~~~~~~~
~~~~~~~~#...##.###.####.....#..#.....#~~~~~~~~~~~~~~~~~~~~~~~~~~~
~~~~~~~~#......###.####.#.#.#######..#~~~~~~~~~~~~~~~~~~~~~~~~~~~
~~~~~~~~#.#.................#........#~~~~~~~~~~~~~~~~~~~~~~~~~~~
~~~~~~~~#####.####..#########....#####~~~~~~~~~~~~~~~~~~~~~~~~~~~
~~~~~~~~#.....##.....##..........#####~~~~~~~~~~~~~~~~~~~~~~~~~~~
~~~~~~~~#..#..##.....##.....#####################################
~~~~~~~~#.........#..##..####~~~~~#.............$................
~~~~~~~~#...#..#.....##.....#~~~~~#..############################
~~~~~~~~#............#####..#######..#~~~~~~~~~~~~~~~~~~~~~~~~~~~
~~~~~~~~#.....#..#...##.....#........#~~~~~~~~~~~~~~~~~~~~~~~~~~~
~~~~~~~~#.#...#......##..####..#######~~~~~~~~~~~~~~~~~~~~~~~~~~~
~~~~~~~~#....##..#...##.....#..##~~~~#~~~~~~~~~~~~~~~~~~~~~~~~~~~
~~~~~~~~##################..#..##~~~~#~~~~~~~~~~~~~~~~~~~~~~~~~~~
~~~~~~~~#~~~~~~~~~~~~~~~##.....##~~~~#~~~~~~~~~~~~~~~~~~~~~~~~~~~
~~~~~~~~##############################~~~~~~~~~~~~~~~~~~~~~~~~~~~
~~~~~~~~~~~~~~~~~~~~~~~~~~~~~~~~~~~~~~~~~~~~~~~~~~~~~~~~~~~~~~~~~
~~~~~~~~~~~~~~~~~~~~~~~~~~~~~~~~~~~~~~~~~~~~~~~~~~~~~~~~~~~~~~~~~
~~~~~~~~~~~~~~~~~~~~~~~~~~~~~~~~~~~~~~~~~~~~~~~~~~~~~~~~~~~~~~~~~
~~~~~~~~~~~~~~~~~~~~~~~~~~~~~~~~~~~~~~~~~~~~~~~~~~~~~~~~~~~~~~~~~
~~~~~~~~~~~~~~~~~~~~~~~~~~~~~~~~~~~~~~~~~~~~~~~~~~~~~~~~~~~~~~~~~
~~~~~~~~~~~~~~~~~~~~~~~~~~~~~~~~~~~~~~~~~~~~~~~~~~~~~~~~~~~~~~~~~
~~~~~~~~~~~~~~~~~~~~~~~~~~~~~~~~~~~~~~~~~~~~~~~~~~~~~~~~~~~~~~~~~
~~~~~~~~~~~~~~~~~~~~~~~~~~~~~~~~~~~~~~~~~~~~~~~~~~~~~~~~~~~~~~~~~
~~~~~~~~~~~~~~~~~~~~~~~~~~~~~~~~~~~~~~~~~~~~~~~~~~~~~~~~~~~~~~~~~
~~~~~~~~~~~~~~~~~~~~~~~~~~~~~~~~~~~~~~~~~~~~~~~~~~~~~~~~~~~~~~~~~
~~~~~~~~~~~~~~~~~~~~~~~~~~~~~~~~~~~~~~~~~~~~~~~~~~~~~~~~~~~~~~~~~
~~~~~~~~~~~~~~~~~~~~~~~~~~~~~~~~~~~~~~~~~~~~~~~~~~~~~~~~~~~~~~~~~
~~~~~~~~~~~~~~~~~~~~~~~~~~~~~~~~~~~~~~~~~~~~~~~~~~~~~~~~~~~~~~~~~
~~~~~~~~~~~~~~~~~~~~~~~~~~~~~~~~~~~~~~~~~~~~~~~~~~~~~~~~~~~~~~~~~
~~~~~~~~~~~~~~~~~~~~~~~~~~~~~~~~~~~~~~~~~~~~~~~~~~~~~~~~~~~~~~~~~
~~~~~~~~~~~~~~~~~~~~~~~~~~~~~~~~~~~~~~~~~~~~~~~~~~~~~~~~~~~~~~~~~
~~~~~~~~~~~~~~~~~~~~~~~~~~~~~~~~~~~~~~~~~~~~~~~~~~~~~~~~~~~~~~~~~
~~~~~~~~~~~~~~~~~~~~~~~~~~~~~~~~~~~~~~~~~~~~~~~~~~~~~~~~~~~~~~~~~
~~~~~~~~~~~~~~~~~~~~~~~~~~~~~~~~~~~~~~~~~~~~~~~~~~~~~~~~~~~~~~~~~
~~~~~~~~~~~~~~~~~~~~~~~~~~~~~~~~~~~~~~~~~~~~~~~~~~~~~~~~~~~~~~~~~
~~~~~~~~~~~~~~~~~~~~~~~~~~~~~~~~~~~~~~~~~~~~~~~~~~~~~~~~~~~~~~~~~
~~~~~~~~~~~~~~~~~~~~~~~~~~~~~~~~~~~~~~~~~~~~~~~~~~~~~~~~~~~~~~~~~
