~~~~~~~~~~~~~~~~~~~~~~~~~~~~~~~~~~~~~~~~~~~~~~~~~~~~~~~~~~~~
~~~~~~~~~~~~~~~~~~~~~~~~~~~~~~~~~~~~~~~~~~~~~~~~~~~~~~~~~~~~
~~~~~~~~~~~~~~~~~~~~~~~~~~~~~~~~~~~~~~~~~~~~~~~~~~~~~~~~~~~~
~~~~~~~~~~~~~~~~~~~~~~~~~~~~~~~~~~~~~~~~~~~~~~~~~~~~~~~~~~~~
~~~~~~~~~~~~~~~~~~~~~~~~~~~~~~~~~~~~~~~~~~~~~~~~~~~~~~~~~~~~
~~~~~######################################################~
~~~~~~################################~~~~~~~~~~~~~~~~~~~~~~
~~~~~~~~#.........................#~~#~~~~~~~~~~~~~~~~~~~~~~
~~~~~~~~#......###.#.###.....##...#~~#~~~~~~~~~~~~~~~~~~~~~~
~~~~~~~~#..#######.#...#####.##..#####~~~~~~~~~~~~~~~~~~~~~~
~~~~~~~~#......@##.#...#..#..##......#~~~~~~~~~~~~~~~~~~~~~~
~~~~~~~~#.####..##.#...#.....##......#~~~~~~~~~~~~~~~~~~~~~~
~~~~~~~~#..###..#......#..#..##.#....#~~~~~~~~~~~~~~~~~~~~~~
~~~~~~~~#.2.....#..#...#..#..##...#..#~~~~~~~~~~~~~~~~~~~~~~
~~~~~~~~#..######......#.....##......#~~~~~~~~~~~~~~~~~~~~~~
~~~~~~~~#..###.....#.##########.#....#~~~~~~~~~~~~~~~~~~~~~~
~~~~~~~~######..####.###....#........#~~~~~~~~~~~~~~~~~~~~~~
~~~~~~~~#...................#..#####.#~~~~~~~~~~~~~~~~~~~~~~
~~~~~~~~####..####..#####.###..#.....#~~~~~~~~~~~~~~~~~~~~~~
~~~~~~~~#......###..###....##..#..#..#~~~~~~~~~~~~~~~~~~~~~~
~~~~~~~~#....#.###..###.....#..#.....#~~~~~~~~~~~~~~~~~~~~~~
~~~~~~~~#.#....###......#...#..#######~~~~~~~~~~~~~~~~~~~~~~
~~~~~~~~#....#####.###...#..#.......##~~~~~~~~~~~~~~~~~~~~~~
~~~~~~~~#...##.###.####.....#..#.....#~~~~~~~~~~~~~~~~~~~~~~
~~~~~~~~#......###.####.#.#.#######..#~~~~~~~~~~~~~~~~~~~~~~
~~~~~~~~#.#.................#........#~~~~~~~~~~~~~~~~~~~~~~
~~~~~~~~#####.####..#########....#####~~~~~~~~~~~~~~~~~~~~~~
~~~~~~~~#.....##.....##..........#####~~~~~~~~~~~~~~~~~~~~~~
~~~~~~~~#..#..##.....##.....###############################~
~~~~~~~~#.........#..##..####~~~~~#..............$.........~
~~~~~~~~#...#..#.....##.....#~~~~~#..######################~
~~~~~~~~#............###....#######..#~~~~~~~~~~~~~~~~~~~~~~
~~~~~~~~#.#...#......##..####.......##~~~~~~~~~~~~~~~~~~~~~~
~~~~~~~~#.#...#......##..####..#######~~~~~~~~~~~~~~~~~~~~~~
~~~~~~~~#.#...#......##..####..#######~~~~~~~~~~~~~~~~~~~~~~
~~~~~~~~#....##..#...##.....#..##~~~~#~~~~~~~~~~~~~~~~~~~~~~
~~~~~~~~##################..#..##~~~~#~~~~~~~~~~~~~~~~~~~~~~
~~~~~~~~#~~~~~~~~~~~~~~~##.....##~~~~#~~~~~~~~~~~~~~~~~~~~~~
~~~~~~~~##############################~~~~~~~~~~~~~~~~~~~~~~
~~~~~~~~~~~~~~~~~~~~~~~~~~~~~~~~~~~~~~~~~~~~~~~~~~~~~~~~~~~~
~~~~~~~~~~~~~~~~~~~~~~~~~~~~~~~~~~~~~~~~~~~~~~~~~~~~~~~~~~~~
~~~~~~~~~~~~~~~~~~~~~~~~~~~~~~~~~~~~~~~~~~~~~~~~~~~~~~~~~~~~
~~~~~~~~~~~~~~~~~~~~~~~~~~~~~~~~~~~~~~~~~~~~~~~~~~~~~~~~~~~~
~~~~~~~~~~~~~~~~~~~~~~~~~~~~~~~~~~~~~~~~~~~~~~~~~~~~~~~~~~~~
~~~~~~~~~~~~~~~~~~~~~~~~~~~~~~~~~~~~~~~~~~~~~~~~~~~~~~~~~~~~
~~~~~~~~~~~~~~~~~~~~~~~~~~~~~~~~~~~~~~~~~~~~~~~~~~~~~~~~~~~~
~~~~~~~~~~~~~~~~~~~~~~~~~~~~~~~~~~~~~~~~~~~~~~~~~~~~~~~~~~~~
~~~~~~~~~~~~~~~~~~~~~~~~~~~~~~~~~~~~~~~~~~~~~~~~~~~~~~~~~~~~
~~~~~~~~~~~~~~~~~~~~~~~~~~~~~~~~~~~~~~~~~~~~~~~~~~~~~~~~~~~~
~~~~~~~~~~~~~~~~~~~~~~~~~~~~~~~~~~~~~~~~~~~~~~~~~~~~~~~~~~~~
~~~~~~~~~~~~~~~~~~~~~~~~~~~~~~~~~~~~~~~~~~~~~~~~~~~~~~~~~~~~
~~~~~~~~~~~~~~~~~~~~~~~~~~~~~~~~~~~~~~~~~~~~~~~~~~~~~~~~~~~~
~~~~~~~~~~~~~~~~~~~~~~~~~~~~~~~~~~~~~~~~~~~~~~~~~~~~~~~~~~~~
~~~~~~~~~~~~~~~~~~~~~~~~~~~~~~~~~~~~~~~~~~~~~~~~~~~~~~~~~~~~
~~~~~~~~~~~~~~~~~~~~~~~~~~~~~~~~~~~~~~~~~~~~~~~~~~~~~~~~~~~~
~~~~~~~~~~~~~~~~~~~~~~~~~~~~~~~~~~~~~~~~~~~~~~~~~~~~~~~~~~~~
~~~~~~~~~~~~~~~~~~~~~~~~~~~~~~~~~~~~~~~~~~~~~~~~~~~~~~~~~~~~
~~~~~~~~~~~~~~~~~~~~~~~~~~~~~~~~~~~~~~~~~~~~~~~~~~~~~~~~~~~~
~~~~~~~~~~~~~~~~~~~~~~~~~~~~~~~~~~~~~~~~~~~~~~~~~~~~~~~~~~~~
~~~~~~~~~~~~~~~~~~~~~~~~~~~~~~~~~~~~~~~~~~~~~~~~~~~~~~~~~~~~
